
 ###############   ################
      #        #   #
      #        #   #
      #        ####################
      #                           #
      #                 ###########
  ########  $    ########
     #   ####        #
     #     #         #
   ###     ######   ###############
    #      #    #              #
    #      #    #############  ####
    ###### #                   #
    #      #                   ##
  #####   #              #######
  #                          # ####
                                                                                              
